A		AH
B 		B EH
C		T S EH
D 		D EH
E 		EY
F		EH F
G		G EY
H		HH AA
I		IY
J		Y OW T
K 		K AA
L		EH L
M		EH M
N 		EH N
O		OW
P		P EH
Q 		K UW
R		EH R
S		EY S
T		T EY
U 		UW
V		F AW
W		V EY
X		IH K S
Y		EH P S AH L AA N
Z		T S EY T
Ä		EY
Ü		EY UW
Ö		EY OW
ß		EY S EY T	
